+-+-+-+-+-+
| | |s    |
+-+ +-+ +-+
| | |     |
+ + + +-+-+
| |   |   |
+ +-+ + + +
|   |   | |
+ + +-+-+ +
| |    e| |
+-+-+-+-+-+
