+-+-+-+-+
|s|   | |
+-+ + +-+
|       |
+-+ + + +
|     | |
+ +-+ +-+
| | |  e|
+-+-+-+-+
